#######
#E    #
#     #
#     #
#     #
#    E#
###I###
   |
###1###
#F    #
#     #
#     #
#     #
#     #
###I###
   |
###1###
#     #
#     #
#     #
#     #
#     #
#######
