#######
#EX   #
#     #
#     #
#     #
#     #
###I###
VVV|VVV
###1###
#F    #
#     #
#     #
#     #
#     #
###I###
VVV|VVV
###1###
#     #
#     #
#     #
#     #
#     #
#######
